ab=från
abdómen=buk
abdominális=som hör till buken
abdúcens=isärförande, utåtförande
abducéra=föra isär eller utåt
abdúctor=isärförare, utåtdragare
abduktion=utåtriktad rörelse
accessórius=extra
acetábulum=ättikskål, höftbensgrop
acrómion=skulderhöjd (jfr acromegali=förstorade lemmar mm och acropolis=stadens högsta punkt)
acústicus=hörande till hörselorganen
ad=till
addúcere=föra till eller samman, (adduktion) inåtriktad rörelse
addúctor=sammanförare
adductórius=som tjänar eller tillhör adductor
adén(o)=körtel-
adipósus=fettrik
áditus=ingång
áfferens=tillförande
ágonist=motståndare
ála=vinge
álbus=vit
alveoláris=hörande till alveolus
alvéolus=liten urholkning eller blåsa
ambíguus=sluttande åt två sidor, dubbel
ampúlla=utvidgning på rör
anális=som hör till anus
anastomósis=förbindelse
anguláris=vinkellik, hörande till vinkel
ángulus=vinkel
ante=framför
antebráchium=underarm
antefléxio=framåtböjning
antérior=framtill liggande, främre
antevérsio=framåtvridning
ántrum=grotta, håla
anuláris=hörande till anulus, ringformig
ánulus=liten ring
ánus=ring, ändtarmens öppning
aórta=stora kroppspulsådern
aórticus=som hör till aorta
apertúra=öppning
ápex=spets
aponeurósis=utbredd sena
apophy´sis=utväxt, frambuktning
appéndix=bihang
áqua=vatten
aquaedúctus=vattenledning
arachnoídea=spindelvävshinna
arachnoidális=som hör till arachnoidea
arcuátus=bågformig
árcus=båge
área=fält, yta
aréola=liten yta
aréola mammae=vårtgård
arréctor=höjare
artéria=artär
arteríola=liten artär
arteriósus=som hör till artär eller som är artärrik
árthron=led
articuláris=som hör till articulatio
articulátio=led
arytenoidéus=skålformig, kannformig
ascéndens=uppåtstigande
ásper=sträv
átlas=bärare, första halskotan
átrium=förmak
atróphia=avmagring
avis=fågel
auditívus=som hör till hörseln
audítus=hörsel
aurícula=litet öra
auriculáris=hörande till örat, öronformat
áuris=öra
auxiliáris=understödjande
axílla=armhåla, axelhåla
axilláris=som hör till axillen
áxis=axel, andra halskotan
ázygos=oparig
bárba=skägg
basális=basal
basiláris=basal-, som hör till basalis
básis=bas
bi=två, dubbel
bíceps=tvåhövdad
bicuspidátus=tvåspetsig
bífidus=tvådelad, kluven
bifurcátio=förgrening
bifurcátus=tvågrenad
bilaterális=tvåsidig
bipennátus=dubbelfjädrad
bivénter=tvåbukig
brachiális=som hör till brachium
bráchium=överarm
branchiogén=utvecklad ur gälarna
brévis=kort
bronchiális=som hör till bronchus
brónchus=luftrör, bronk
búcca=kind
buccális=som hör till bucca
buccinátor=hornblåsare
búlbus=lök, knöl
búlla=blåsa, upphöjning
búrsa=påse, säck
cadáver=lik
caécum=blindtarm
caerúleus=blå
calcáneus=hälben
cálcar=sporre
cálix=bägare
callósus=valkig
cállus=förhårdnad
calvária=skalltaket
cámera=kammare
canalículus=liten kanal
canális=kanal
canínus=som hör till hörntand, från hund
cánis=hund
capilláris=hårliknande
capíllus=hår
capitátus=huvudförsedd
capítulum=litet huvud
cápsula=kapsel
capsuláris=som hör till capsula
cáput=huvud
cárdia=övre magmunnen
cardíacus=som hör till hjärta eller magmun
carína=båtköl
carnósus=köttig
caro=kött
carótis=halspulsådern
caróticus=som hör till carotis
cárpeus=som hör till carpus
cárpus=handrot, handlov
cartilaginéus=broskliknande
cartilaginósus=broskhaltig
cartilágo=brosk
carúncula=vårtformig upphöjning
cáuda=svans
caudális=i riktning mot svansen
caudátus=svansförsedd
cavernósus=hålrik
cávitas=urholkning
cávum=håla
cávus=ihålig
célla=rum, vind
céllula=liten cell
centrális=placerad i mitten
céntrum=medelpunkt
céphale=huvud
cephálicus=som hör till cephale
cerebelláris=som hör till cerebellum
cerebéllum=lillhjärna
cerebrális=som hör till cerebrum
cérebrum=storhjärna
cerúmen=öronvax
cervicális=som hör till halsen
cérvix=hals
chiásma=korsning
choána=bakre näsöppningen
cholédochus=gemensamma gallgången
chondrális=som hör till chondros
chóndros=brosk
chórda=sträng
chorioidéa=ögats kärlhinna
chórion=en fosterhinna
chy´lus=tarmlymfa
ciliáris=som hör till strålkroppen
cílium=ögonhår
cinéreus=askgrå
cíngulum=gördel, nervbana i storhjärnan
circuláris=som går runt om
circumdúctio=i cirkel
circumferénsia=omkrets
cistérna=vätskebehållare
cláustrum=stängsel, spärr
clávis=nyckel
clavícula=nyckelben
claviculáris=som hör till clavicula
clítoris=kittlaren
clívus=sluttning
coccygéus=som hör till os coccygis, göknäbbsliknande
coccy´gicus=gökliknande
cóccyx=gök
cóchlea=snäcka
cochleáris=som hör till cochlea
coelíacus=som hör till bukhålan
collaterális=på sidan av
collículus=liten kulle
cóllum=hals
cólon=tjocktarm
cólicus=som hör till colon
colúmna=pelare
commissúra=förbindelse
commúnicans=sammanhängande
commúnis=gemensam
compáctus=hoptryckt
compósitus=sammansatt
cóncha=mussla, näsmussla
conchális=som hör till concha
condyláris=som hör till condylus
condyloidéus=condylusliknande
cóndylus=ledhuvud
conjugátus=förbunden
conjunctivális=som hör till conjunctiva
conjunctívus=förbindande
conoidéus=kägelformad
constríctor=sammandragare
contórtus=vriden
cónus=kägla, kon
convéxus=konvex
cópula=band, förbindelse
cópulo=sammanbinda
cor=hjärta
coracoidéus=korpnäbbslik
córium=läderhud
córnea=hornhinna
corneális=som hör till cornea
córnu=horn
coróna=krona, krans, diadem
coronális (coronárius)=som hör till corona
coronoidéus=kråknäbbslik
córpus=kropp
corpus ciliare=strålkropp
corpúsculum=liten kropp
córtex=bark
corticális (cortical)=som hör till cortex
cósta=revben
costális=som hör till costa
cóxa=höft
craniális=riktad mot huvudet
cránium=skalle
crássus=tjock
cremáster=upphängare, band
cribrósus=silliknande
cricoidéus=ringformig
crísta=list, kam, plym
cruciátus=korsformad (korsfäst)
crurális=som hör till crus
crus=skänkel
cúbitus=armbåge
cuboidéus=kubisk
cuneifórmis=kilformig
cúneus=kil
cúpula=liten kupol
curvatúra=krökning, båge
cúspis=spets, spjut
cutáneus=som hör till cutis
cútis=hud
cylindroidéus=cylinderliknande
cy´sta=blåsa
cy´sticus=som hör till cysta
dartos=flådd
decussátio=korsning
déferens=bortledande
deltoidéus=trekantig
dens=tand
dentátus=tandförsedd
depréssor=nedtryckare
dérma=hud
descéndens=nedåtgående
desmál=av bindväv
déxter=höger
diaphrágma=skiljevägg, mellangärde
diaphragmáticus=som hör till diaphragma
diaphy´sis=mittstycke på rörben
diarthrósis=led
diástole=utvidgning
diencéphalon=mellanhjärna
di=dubbel, två
digástricus=tvåbukig
dígitus=finger
dilatátio=utvidgning
díploë=skallbenens spongiösa substans
diplóicus=som tillhör diploë
díscus=skiva
dislocátio=förflyttning
distális=liggande på avstånd
divertículum=liten utbuktning
dorsális=mot ryggsidan, som hör till ryggen
dórsum=rygg
dúcere=föra
dúctulus=liten gång
dúctus=gång
duodenális=som hör till duodenum
duodénum=tolvfingertarmen
dúrus=hård, stark, grov
ecto=yttre, utåt
ectoderma=yttre groddbladet
éfferens=utåtledande
ejaculatórius=som tömmer ut sperma
ejaculátio=uttömning av sperma
émbryo=foster
eminéntia=upphöjning
emissárium=avflödeskanal
encéphalon=hjärna
endo=inre, inåt
endoly´mpha=vätska i hinnlabyrinten i innerörat
endomy´sium=bindväv i muskeln
entoderma=inre groddbladet
epéndyma=överdrag
epi=på
epicóndylus=utbuktning på condylus
epidérmis=överhud
epidídymis=bitestikel
epididy´midis=som hör till epididymis
epigástrium=maggropen
epiglóttis=struplock
epíphysis=ände på rörben
epitympánicus=ovanför trumhålan
equínus=som hör till häst
eréctor=lyftare
ethmoidális=som hör till silbenet
etmoidéus=silliknande
éthmos=sil
exo=från, utifrån, utåt
excavátio=urholkning
exodérma=yttre groddbladet
exténdo=sträcka
exténsio (extension)=sträckning
exténsor=sträckare
extensórius=som hör till sträckmuskel
extérnus=yttre
extra=utanför, bortom
extrémitas=extremitet
extrémus=ytterst
fabélla=liten böna
faciális=som hör till ansiktet
fácies=yta, ansikte, utseende
falcifórmis=skärformad
falx=skära
fáscia=band, bindvävshinna
fascículus=bunt, sträng
fel=galla
félleus=som hör till galla
feminínus=kvinnlig
femorális=som hör till femur
femur=lår, lårben
fenéstra=fönster
fetális=som hör till foster
fétus=foster
fibra=fiber, tråd
fibrílla=fin tråd
fibrocartilágo=trådbrosk
fibrósus=trådrik
fíbula=vadben
fibuláris=hörande till fibula
filifórmis=trådformig
fílum=tråd
fímbria=frans
fissúra=spricka
fíxus=fast
flávus=gul
fléxio (flexion)=böjning
fléxor=böjare
flexúra=böjning
foliátus=försedd med blad
fólium=blad
follículus=liten säck
forámen=hål, öppning
fórceps=tång
fórnix=båge
fóssa=grop, dike, kanal
fóssula=liten grop
fovea=grop
foveola=liten grop
fractúra=brott
frénulum=liten töm
frons=panna, framsida
frontális=som hör till frons
fúndus=botten
fungifórmis=svampformig
fúngus=svamp
funículus=sträng, tunnt rep
fusifórm=spolformad
fúsus=spole
gálea=hjälm, huva
gánglion=nervknuta
gáster=mage, buk
gástricus=som hör till gaster
gastrocnémius=vadmuskel
geméllus=dubbel
génesis=uppkomst, födelse
genículum=litet knä
genitália=könsorganen
genitális=som hör till genitalia
génu=knä
gingíva=tandkött
gingivális=som hör till gingiva
gínglymus=gångjärnsled
glándula=körtel
glans=ollon
glénoidalis=glänsande som ögongloben
glóbus=kula
glomérulum=litet nystan
glómus=nystan
glósso=som hör till tungan
glossopharyngéus=som hör till tunga & svalg
glóttis=struphuvudets ljudapparat
glutéus=som hör till glutos
glútos=säte
grácilis=tunn, smal
gránulum=litet korn
granuláris=kornig
granulósus=kornrik
gríseus=grå
gustatórius=som hör till gustus
gústus=smak
gy´rus=vindling
hábitus=hållning, tillstånd
hállux=stortå
hamátus=hakförsedd
hámulus=liten hake
haústrum=ämbar, tjocktarmens utbuktningar
helix=del av öronmusslan
hemi=halv
hépar=lever
hepáticus=som hör till levern
hiátus=glipa, klyfta
hílus=den plats där kärl och nerver når ett organ
histo=vävnad
hómo=människa
húmerus=överarmsben
húmor=vätska
hy´men=mödomshinna
hyoidéus=u-formad (os hyoideum = tungbenet)
hypo=under
hyper=över
hyperplasía=förökning
hypertrophía=förstoring
hypophy´sis=undre hjärnbihanget
íleum=distala delen av tunntarmen
ilíacus=som hör till os ilium
ília=tarmar
ílium=som hör till ilia
impréssio=intryckning
incisívus=framtand
íma; ímus=nederst
incisúra=inskärning
inclinátio=lutning, böjning
inclino=böja, vända, förändra, tveka
íncus=städ
índex=pekfinger
inférior=nedre
infra=nedanför
infundíbulum=tratt
ínguen=ljumske
inguinális=som hör till inguen
innominátus=obenämnd
inscríptio=inskrift, stråk
inséro=sätta in i
insértio=fäste
ínsula=ö
integuméntum=täcke, hud
inter=mellan
intermédius=mitt i mellan
intérnus=inre
interstítium=mellanrum
intestínum=tarm
intra=inom
intumescéntia=ansvällning
invérsus=omvänd
íris=regnbågshinna
ischiádicus=som hör till sittbenet
íschium=säte
iso=lika
ísthmus=smal förbindelse
jejúnum=tomtarm
jejúnus=måttfull, tom
jejunális=som hör till jejunum
juguláris=som hör till jugulum
jugulum=halsens främre parti
ky´phosis=dorsalt konvex krökning av ryggraden
kri´kos (grekiska)=ring (ex cartilago cricoidea)
labiális=som hör till lábium
labium (lábrum)=läpp
labyrínthus=labyrint
lac=mjölk
lácero=riva sönder, förolämpa, slösa pengar
laciniátus=som är sönderriven
lácrima=tår, nektar
lacrimális=som hör till tårorganen
láctifer=mjölkförande
lacúna=hål, damm, tomrum, brist
lambdoidéus=lambdaformad
lamélla=tunt blad
lámina=platta
lanúgo=ullhår, fjun
lárynx=struphuvud
laterális=sidobelägen
latíssimus=bredast
látus=bred, sida, omfattande
lens=lins
lentifórmis=linsformad
levátor=höjare
líbere=fritt, öppet
líbero=lyfta, höja, frigöra
líen=mjälte
lienális=som hör till lien
ligaméntum=band
límbus=rand
línea=linje
língua=tunga, språk
língula=liten tunga
linguális=som hör till lingua
liquid=klar, tydlig, säker
líquor=vätska
lóbulus=liten flik eller lob
lóbus=flik, lob
lócus=plats
longíssimus=längst
longitudinális=längsriktad
lóngus=lång
lordósis=framåt konvex krökning av ryggraden
lumbális=som hör till länden eller ländryggen
lumbricális=maskliknande
lúmbus=länd
lúmen=ljus, öga, förståelse
lúna=måne
lunátus=månskäreformad
lúnula=måne (liten)
lúteus=gul
luxátio=vridning ur led
ly´mpha=vävnadsvätska
lympháticus=hörande till lymfsystemet
lymphonódus=lymfknuta
macerátio=uppmjukning
macro=stor
mácula=fläck, misstag
mágnus=stor, viktig
májor=större
május=större
mála=kind
maláris=som hör till mala
malleoláris=som hör till malleolus
malléolus=fotknöl (liten hammare)
málleus=hammare
mámma=kvinnöbröst, bröstkörtel
mammális=som hör till mamma
mammilláris=bröstvårteliknande
mandíbula=underkäke
manúbrium=handtag
mánus=hand, handskrift
marginális=nära kanten
márgo=rand
masculínus=manlig
mássa=klump
masséter=tuggmuskel
masticátio=tuggning
mastoidéus=bröstvårteliknande
mástos=bröstvårta
máter=moder, hjärnhinna
maxílla=överkäksben
maximus=störst
meátus=gång
mediális=mittorienterad
mediánus=mellerst
médium=alldaglig, lagom
médius=central, i mitten
medúlla=märg
medulláris=som hör till medulla
membrána=hinna
membranósus=hinnliknande
mémbrum=lem
meningéus=som hör till meninx
méninx=hjärnhinna
meníscus=halvmåne, halvmånformig broskskiva
mentális=som hör till hakan, själslig
méntum=haka
meso=mitt
mesencéphalon=mitthjärna
mesentérium=tarmkäx
mesiális=mittbelägen
meta=efter
metacárpus=mellanhand
metatársus=mellanfot
metro=livmoder (jfr myometrium)
micro=liten
mínimus=minst
mínor=mindre
mínus=liten
mítra=mössa, huva
móbilis=rörlig
moláris=som hör till kindtand
móllis=mjuk, flexibel, rörlig
mono=en-
mons=berg
morphos=form
morphólogia=formlära
mucósa=slemhinna
mucósus=slemrik
mucus=slem
musculáris=som hör till muskel
músculus=muskel
mutátio=förändring
myelencéphalon=bakhjärna
my´elo=märg-
mylo=som hör till kindtand
myo=muskel
myocárdium=hjärtväggens muskelskikt
myométrium=livmoderns muskelskikt
náris=näsöppning
nasális=som hör till nasus
násus=näsa (yttre del)
naviculáris=båtformig
nekrósis=vävnadsdöd
nérvus=nerv
niger=svart
nódulus=liten knuta
nódus=knuta
núcha=nacke
nuchális=som hör till nucha
núcleus=kärna
oblíquus=sned
oblongátus=förlängd
obturátor=tilltäppare
obturatórius=som hör till obturator
occipitális=bakhuvud-, hörande till bakhuvudet
oculomotórius=hörande till ögats rörelse
óculus=öga
odont-=tand-
oesophágus=matstrupe
olécranon=armbågsutskott
olfactórius=som hör till olfactus
olfáctus=luktsinne
oliváris=som hör till oliven (nucleus olivaris i medulla oblongata)
oméntum=bukhinnenätet
omphálo-=navel-
ontogénesis=individens utveckling
oophor(o)=som hör till ovarium
ophtálmicus=som hör till ögat
oppónens=motställande
ópticus=som hör till seendet
orális=som hör till munnen (oris)
orbiculáris=ringformig
órbita=ögonhåla, djupa hjulspår
orbitális=som hör till orbita
orgánum=organ, musikinstrument
orifícium=mynning
orígo=ursprung, början, källa, förfader
os, oris, ora=mun, öppning, källa, mask
os, ossis, ossa=ben
ósseus=av ben
óstium=mynning, ingång, dörr
ovális=oval
ovárium=äggstock
palatínus=som hör till palatum
palátum=gom
palma=handflata, palm
palmáris=som hör till palma
pálpebra=ögonlock
páncreas=bukspottkörtel
pancreáticus=som hör till pancreas
pannículus=liten lapp
papílla=bröstvårta, bröst
para=bredvid
páries=vägg
parietális=som hör till os parietale
parotidéus=som hör till parotis
parótis=öronspottkörtel
pars=del
parvus=liten
patélla=knäskål
patelláris=som hör till patella
pécten=kam
pectinéus=som hör till pecten
pectorális=som hör till pectus
péctus=bröst, (hjärta)
pedículus=liten fot, stjälk, lus
pellúcidus=genomskinlig
pelvínus=som hör till pelvis
pelvis=bäcken
pénis=svans
penna=fjäder, vinge
pennátus=fjädrad
pérforans=genomborrande
perforátus=genomborrad
peri=runt omkring
pericárdium=hjärtsäcksblad
perichóndrium=broskhinna
perineális=som hör till perineum
perinéum=bäckenbotten
periósteum=benhinna
peritonéum=bukhinna
perone=vadben
peronéus=som hör till perone
perpendiculáris=lodrät
pes=fot
petrósus=klippig, som hör till klippbenet
phálanx=falang (fingrar & tår)
pharyngéus=som hör till pharynx
phárynx=svalg
phreno=som hör till diafragma eller själen
phrénicus=som hör samman med mellangärdet
phylogénesis=släktets utveckling
pílus=hårstrå, obetydlighet
pineális=tallkottlik
pirifórmis=päronformad
pisifórmis=ärtformad
placenta=moderkaka
plánta=fotsula
plantáris=som hör till planta
plánum=yta
platy´sma=utbredd platta
pléura=lungsäck
pleurális=som hör till pleura
pléxus=fläta
plíca=veck
pneumáticus=lufthaltig, som hör till andningen
póllex=tumme, stortå
poly=många
pons=brygga
póples=knäveck
poplitéus=som hör till poples
pórta=port
pórtio=del (ex del av uterus)
pórus=öppning
post=efter
postérior=bakre
pre=framför
prematúre=för tidig
premoláres=framför molarerna (kindtänder)
prepútium=förhud
primárius=ursprunglig
prímus=första
pro=före, fram, ut
procéssus=utskott
profúndus=djup, tjock, tät
prolatio=föra fram, utvidgning
próminens=framskjutande, utskott
prominéntia=upphöjning
promontórium=upphöjning
pronátor=inåtvridare
próprius=egentlig, egen, speciell
próstata=blåshalskörtel
protuberántia=upphöjning
proximális=som ligger närmare mitten på kroppen än...
pseudo=falsk
psoa=ljumske
psóas=ländmuskel, som passerar ljumsken
pterygoidéus=vingformad
púbes=blygd (område kring yttre könsorganen)
púbicus=som hör till pubes
pudéndum=blygd (yttre könsorgan)
púlmo=lunga
pulmonális=lung-, som hör till lungan
pulpa=mjuk massa, kött
pulpósus=bestående av mjuk substans
pupílla=pupill, vakt
líbere=fritt, öppet
púpula=pupill
pylórus=portvakt, nedre magmunnen
pyramidális=pyramidformad
py´ramis=pyramid
quadrátus=fyrkantig
quadri-=fyr-
quadríceps=fyrhövdad
radiális=som hör till radius
radiátus=försedd med strålar
rádius=strålben, stråle, stav
rádix=rot
rámus=gren
ráphe=söm
recéssus=fördjupning, ficka, reträtt(-plats)
rectális=som hör till rectum
réctum=ändtarm
réctus=rak
recúrrens=som återvänder
régio=område
ren=njure
renális=som hör till ren (njuren)
respiratórius=som har med andningen att göra
rete=nät
reticuláris=nätliknande
retículum=litet nät
retína=ögats näthinna
retináculum=band
retro=bakåt, bakom
rhino=näs-
rhomboencéphalon=ruthjärna
rhomboidéus=rutformig
ríma=springa
risórius=skratt- (risus = skratt)
rostrált=mot munnen
róstrum=nos, näbb
rotátor=omrörare
rotúndus=rund
rúber=röd
rúbor=rodnad, skam
saccifórmis=säckformad
sácculus=liten säck
sáccus=säck
sacrális=som hör till sacrum
sácrum=korsben ("det heliga benet")
sagítta=pil
sagittális=som hör till sagitta
salíva=spott
saliváris=som hör till saliv
sálpinx=äggledare
saphéna=av alsáphen=den dolda; ven på benet
sártor=skräddare
sartórius=som tillhör sartor
scála=trappa
scaphoidéus=båtformad
scápula=skulderblad
scapuláris=som hör till scapula
scéletos=torr
scéletum=skelett
scléra=ögats senhinna
scoliósis=ryggradskrökning i frontalplanet
scrotális=som hör till scrotum
scrotum=pung
sebáceus=talgalstrande
sébum=talg
sélla=sadel
sémi-=halv-
semicirculáris=halvcirkelformad
semilúnaris=halvmåneformad
sénsus=känsla, sinne
séptum=skiljevägg
serrátus=sågtandad (serra=såg)
sesamoidéus=sesamfröliknande
sigmoidéus=s-formad
símplex=enkel
singuláris=enkel, ensam, unik
siníster=vänster
sínus=hålighet, bukt
sítus (äv. positus)=läge
soláris=som solen
sóleus=flundrelik
sóma=kropp
somato=som hör till soma
spátium=rum, mellanrum
spérma=säd
spermáticus=som hör till sperma
sphenoidális=som hör till kilbenet
sphenoidéus=kilformad
spheroidéus=rund
sphíncter=ringformig slutmuskel
spína=tagg, ås, ryggrad
spinális=som hör till spina
spinósus=taggig
spirális=spiralformad
splánchnicus=som hör till inälvor
splénius=remformad
spondylo=som hör till kotor
spongiósus=svampig
spúrius=falsk
squáma=fjäll
stapédius=som hör till stapes
stapes=ben i mellanörat
státus=jämvikt, stadium
stélla=stjärna
stelláris=stjärnformad
sternális=som hör till sternum
sternum=bröstben
stóma=mun
strátum=lager, skikt
stria=strimma
striátus=strimmig, streckad
styloidéus=griffelformad
sub=under
subarachnoidális=under spindelvävshinnan
subcútis=underhud
substántia=substans, egenskap
súdor=svett
sudórifer=svettalstrande
súlcus=fåra
súper=över
supercílium=ögonbryn
superficiális=ytligt belägen
supérior=ovanför belägen
supinátor=utåtvridande, uppåtvridande
supra=över, ovanför
suprémus=över, överst
súra=vad
surális=som hör till sura
suspensórius=stödjande
sustentáculum=stöd
sustento=stödja
sutúra=söm
sy´mphysis=sammanväxning mellan två ben
syn=samman, med
synchondrósis=broskförbindelse mellan två ben
syndesmósis=bindvävsförbindelse mellan två ben
synergíst=medarbetare (ergon=arbetare)
synóvia=ledvätska
synoviális=som hör till synovia
sy´stole=sammandragning
taénia=band
tálus=språngben
tarsális=som hör till tarsus
tarsus=vrist
tectórius=täckande
tegmentális=som hör till tegmentum
tegméntum=täcke, tak
téla=väv, tyg, vävnad, vävnadsskikt
temporális=som hör till tempus
témpus=tinning, tid, epok
tendinéus=senig
tendinósus=senrik
téndo=sena, försöka, sträcka ut
ténsor=spännare
tentórium=tält
ténius=tunn
téres=rund
terminális=gräns, slut
téstis=testikel
thálamus=synhög
théca=kapsel, behållare
thénar=tumvalken
thorácicus=som hör till thorax
thórax=bröstkorg
thy´mus=bräss
thy´reos=sköld
tíbia=skenben
tibiális=som hör till tibia
tonsílla=mandel, halsmandel
tonsilláris=som hör till tonsilla
tónus=spänning
trabécula=liten balk
trachéa=luftrör
tracheális=som hör till trachea
tráctus=bana, rörelse
trágus=bock, örflik
transvérsus=tvärställd
trapezoidéus=trapetsformad
tri=tre
trianguláris=trekantig
tríceps=trehövdad
trigéminus=trefaldig, tredelad
trigónum=trekant
tríquetrus=trekantig
trochánter=benknöl (på femur)
trochantéricus=som hör till trochanter
tróchlea=rulle
trochleáris=som hör till trochlea
trúncus=stam
túba=trumpet, rör
tubárius=som hör till tuba
túber=kulle, knöl
tubérculum=liten knöl
tuberósitas=skrovlighet
tuberósus=knölig
túbulus=litet rör
túnica=hinna, beklädnad
túrcicus=turkisk
tympánicus=som hör till cavum eller membrana tympani
ty´mpanum=trumma
ulna=armbågsben
ulnáris=som hör till ulna
umbilicális=som hör till umbilicus
umbílicus=navel
uncinátus=hakförsedd
úncus=hake
únguis=nagel, hov
uni=en
unilaterális=ensidig
unipennátus=enfjädrad
úrachus=uringång
uréter=urinledare
uréthra=urinrör
úterus=livmoder
utrículus=liten slang
úvula=gomspene
vagína=slida
vaginális=som hör till vagina
vágus=kringströvande (äv. vulgivagus)
válgus=vriden, sned (hallux valgus=felställd stortå)
válva=klaff
várus=sned (genu varum=hjulbent)
vas=kärl
vasculósus=kärlrik
vástus=utsträckt
vélum=segel
véna=ven
venósus=venrik, som hör till ven
vénter=buk
ventrális=mot buksidan till, hörande till buken
ventriculáris=som hör till ventriculus
ventrículus=magsäck, hjärtkammaren, rum i hjärnan
vermifórmis=maskformad
vérmis=mask
vértebra=kota
vertebrális=som hör till vertebra
vértex=topp, spets
verticális=lodrät
vérus=sann
vesíca=blåsa
vesicális=som hör till vesica
vesícula=liten blåsa
vestibuláris=som hör till vestibulum
vestibulum=förrum
vibríssa=näshår
víllus=tarmludd
víscera=inälvor
viscerális=som hör till viscera
viscus=kött, inre organ, inälvor
vísus=syn
vítreus=glasartad
vocális=ljudande, som tillhör rösten
vóla=handflata
voláris=som hör till vola
vómer=plogblad, plogben
vórtex=virvel
xiphoidéus=svärdformig
zóna=gördel
zygóma=ok
zygomáticus=okliknande